[
  {
    "name": "满",
    "map": [
      [-1, -1, -1, -1, -1, -1, -1, -1, -1, -1, -1, -1, -1, -1, -1, -1, -1, -1, -1],
      [-1, 0, 0, 0, 0, 0, 0, 0, 0, 0, 0, 0, 0, 0, 0, 0, 0, 0, -1],
      [-1, 0, 0, 0, 0, 0, 0, 0, 0, 0, 0, 0, 0, 0, 0, 0, 0, 0, -1],
      [-1, 0, 0, 0, 0, 0, 0, 0, 0, 0, 0, 0, 0, 0, 0, 0, 0, 0, -1],
      [-1, 0, 0, 0, 0, 0, 0, 0, 0, 0, 0, 0, 0, 0, 0, 0, 0, 0, -1],
      [-1, 0, 0, 0, 0, 0, 0, 0, 0, 0, 0, 0, 0, 0, 0, 0, 0, 0, -1],
      [-1, 0, 0, 0, 0, 0, 0, 0, 0, 0, 0, 0, 0, 0, 0, 0, 0, 0, -1],
      [-1, 0, 0, 0, 0, 0, 0, 0, 0, 0, 0, 0, 0, 0, 0, 0, 0, 0, -1],
      [-1, 0, 0, 0, 0, 0, 0, 0, 0, 0, 0, 0, 0, 0, 0, 0, 0, 0, -1],
      [-1, 0, 0, 0, 0, 0, 0, 0, 0, 0, 0, 0, 0, 0, 0, 0, 0, -1, -1],
      [-1, -1, -1, -1, -1, -1, -1, -1, -1, -1, -1, -1, -1, -1, -1, -1, -1, -1, -1]
    ]
  },
  {
    "name": "方块阵列",
    "map": [
      [-1, -1, -1, -1, -1, -1, -1, -1, -1, -1, -1, -1, -1, -1, -1, -1, -1, -1, -1],
      [-1, 0, 0, -1, 0, 0, 0, 0, -1, 0, 0, 0, -1, 0, 0, -1, 0, 0, -1],
      [-1, 0, 0, -1, 0, 0, 0, 0, -1, 0, 0, 0, -1, 0, 0, -1, 0, 0, -1],
      [-1, -1, -1, 0, -1, -1, -1, -1, -1, -1, -1, -1, -1, -1, -1, 0, -1, -1, -1],
      [-1, 0, 0, -1, 0, 0, 0, 0, -1, 0, 0, 0, -1, 0, 0, -1, 0, 0, -1],
      [-1, 0, 0, -1, 0, 0, 0, 0, -1, 0, 0, 0, 0, 0, 0, -1, 0, 0, -1],
      [-1, 0, 0, -1, 0, 0, 0, 0, -1, 0, 0, 0, -1, 0, 0, -1, 0, 0, -1],
      [-1, -1, -1, 0, -1, -1, -1, -1, -1, -1, -1, -1, -1, -1, -1, 0, -1, -1, -1],
      [-1, 0, 0, -1, 0, 0, 0, 0, -1, 0, 0, 0, -1, 0, 0, -1, 0, 0, -1],
      [-1, 0, 0, -1, 0, 0, 0, 0, -1, 0, 0, 0, -1, 0, 0, -1, 0, 0, -1],
      [-1, -1, -1, -1, -1, -1, -1, -1, -1, -1, -1, -1, -1, -1, -1, -1, -1, -1, -1]
    ]
  },
  {
    "name": "光翼",
    "map": [
      [0, 0, 0, 0, 0, 0, -1, -1, -1, -1, -1, -1, -1, 0, 0, 0, 0, 0, 0],
      [0, 0, 0, 0, 0, 0, 0, -1, -1, 0, -1, -1, 0, 0, 0, 0, 0, 0, 0],
      [-1, 0, 0, 0, 0, 0, 0, 0, -1, -1, -1, 0, 0, 0, 0, 0, 0, 0, -1],
      [-1, -1, 0, 0, 0, 0, 0, 0, 0, -1, 0, 0, 0, 0, 0, 0, 0, -1, -1],
      [-1, -1, -1, 0, 0, 0, 0, 0, 0, -1, 0, 0, 0, 0, 0, 0, -1, -1, -1],
      [-1, -1, -1, -1, -1, -1, -1, -1, -1, 0, -1, -1, -1, -1, -1, -1, -1, -1, -1],
      [-1, -1, -1, 0, 0, 0, 0, 0, 0, -1, 0, 0, 0, 0, 0, 0, -1, -1, -1],
      [-1, -1, 0, 0, 0, 0, 0, 0, 0, -1, 0, 0, 0, 0, 0, 0, 0, -1, -1],
      [-1, 0, 0, 0, 0, 0, 0, 0, -1, -1, -1, 0, 0, 0, 0, 0, 0, 0, -1],
      [0, 0, 0, 0, 0, 0, 0, -1, -1, -1, -1, -1, 0, 0, 0, 0, 0, 0, 0],
      [0, 0, 0, 0, 0, 0, -1, -1, -1, -1, -1, -1, -1, 0, 0, 0, 0, 0, 0]
    ]
  },
  {
    "name": "菱形",
    "map": [
      [0, 0, -1, -1, -1, -1, -1, -1, -1, -1, -1, -1, -1, -1, -1, -1, -1, 0, 0],
      [0, -1, -1, -1, -1, 0, -1, -1, -1, -1, -1, -1, -1, 0, -1, -1, -1, -1, 0],
      [-1, -1, -1, -1, 0, 0, 0, -1, -1, -1, -1, -1, 0, 0, 0, -1, -1, -1, -1],
      [-1, -1, -1, 0, 0, 0, 0, 0, -1, -1, -1, 0, 0, 0, 0, 0, -1, -1, -1],
      [-1, -1, 0, 0, 0, 0, 0, 0, 0, -1, 0, 0, 0, 0, 0, 0, 0, -1, -1],
      [-1, 0, 0, 0, 0, 0, 0, 0, 0, 0, 0, 0, 0, 0, 0, 0, 0, 0, -1],
      [-1, -1, 0, 0, 0, 0, 0, 0, 0, -1, 0, 0, 0, 0, 0, 0, 0, -1, -1],
      [-1, -1, -1, 0, 0, 0, 0, 0, -1, -1, -1, 0, 0, 0, 0, 0, -1, -1, -1],
      [-1, -1, -1, -1, 0, 0, 0, -1, -1, -1, -1, -1, 0, 0, 0, -1, -1, -1, -1],
      [0, -1, -1, -1, -1, 0, -1, -1, -1, -1, -1, -1, -1, 0, -1, -1, -1, -1, 0],
      [0, 0, -1, -1, -1, -1, -1, -1, -1, 0, -1, -1, -1, -1, -1, -1, -1, 0, 0]
    ]
  },
  {
    "name": "迷宫",
    "map": [
      [0, 0, 0, 0, 0, 0, 0, 0, 0, 0, 0, 0, 0, 0, 0, 0, 0, 0, 0],
      [0, -1, -1, -1, -1, -1, -1, -1, -1, -1, -1, -1, -1, -1, -1, -1, -1, -1, 0],
      [0, -1, 0, 0, 0, 0, 0, 0, 0, 0, 0, 0, 0, 0, 0, 0, 0, -1, 0],
      [0, -1, 0, -1, -1, -1, -1, -1, -1, -1, -1, -1, -1, -1, -1, -1, 0, -1, 0],
      [0, -1, 0, -1, 0, 0, 0, 0, 0, 0, 0, 0, 0, 0, -1, -1, 0, -1, 0],
      [0, -1, 0, -1, 0, -1, -1, -1, -1, -1, -1, -1, -1, -1, -1, -1, 0, -1, 0],
      [0, -1, 0, -1, 0, 0, 0, 0, 0, 0, 0, 0, 0, 0, 0, 0, 0, -1, 0],
      [0, -1, 0, -1, -1, -1, -1, -1, -1, -1, -1, -1, -1, -1, -1, -1, -1, -1, 0],
      [0, -1, 0, 0, 0, 0, 0, 0, 0, 0, 0, 0, 0, 0, 0, 0, 0, 0, 0],
      [0, -1, -1, -1, -1, -1, -1, -1, -1, -1, -1, -1, -1, -1, -1, -1, -1, -1, -1],
      [0, 0, 0, 0, 0, 0, 0, 0, 0, 0, 0, 0, 0, 0, 0, 0, 0, 0, 0]
    ]
  },
  {
    "name": "男女",
    "map": [
      [-1, -1, -1, 0, 0, -1, -1, -1, -1, -1, -1, -1, 0, 0, 0, 0, -1, -1, -1],
      [-1, -1, 0, 0, 0, 0, -1, -1, -1, -1, -1, 0, 0, 0, 0, 0, 0, -1, -1],
      [-1, 0, 0, 0, 0, 0, 0, -1, -1, -1, 0, 0, 0, 0, 0, 0, 0, 0, -1],
      [0, 0, -1, 0, 0, -1, 0, 0, -1, -1, -1, 0, 0, 0, 0, 0, 0, -1, -1],
      [-1, -1, -1, 0, 0, -1, -1, -1, -1, -1, -1, -1, 0, 0, 0, 0, -1, -1, -1],
      [-1, -1, -1, 0, 0, -1, -1, -1, -1, -1, -1, -1, -1, 0, 0, -1, -1, -1, -1],
      [-1, -1, 0, 0, 0, 0, -1, -1, -1, -1, 0, 0, 0, 0, 0, 0, 0, 0, -1],
      [-1, 0, 0, 0, 0, 0, 0, -1, -1, -1, 0, 0, 0, 0, 0, 0, 0, 0, -1],
      [0, 0, 0, 0, 0, 0, 0, 0, -1, -1, -1, -1, -1, 0, 0, -1, -1, -1, -1],
      [-1, 0, 0, 0, 0, 0, 0, -1, -1, -1, -1, -1, -1, 0, 0, -1, -1, -1, -1],
      [-1, -1, 0, 0, 0, 0, -1, -1, -1, -1, -1, -1, -1, 0, 0, -1, -1, -1, -1]
    ]
  },
  {
    "name": "圆圈",
    "map": [
      [0, 0, -1, -1, 0, -1, -1, 0, 0, 0, 0, 0, -1, -1, 0, -1, -1, 0, 0],
      [0, -1, -1, 0, -1, -1, 0, -1, -1, -1, -1, -1, 0, -1, -1, 0, -1, -1, 0],
      [0, -1, 0, -1, -1, 0, -1, -1, 0, 0, 0, -1, -1, 0, -1, -1, 0, -1, 0],
      [0, -1, 0, -1, 0, -1, -1, 0, -1, -1, -1, 0, -1, -1, 0, -1, 0, -1, 0],
      [0, -1, 0, -1, 0, -1, 0, -1, -1, 0, -1, -1, 0, -1, 0, -1, 0, -1, 0],
      [0, -1, 0, -1, 0, -1, 0, -1, 0, -1, 0, -1, 0, -1, 0, -1, 0, -1, 0],
      [0, -1, 0, -1, 0, -1, 0, -1, -1, 0, -1, -1, 0, -1, 0, -1, 0, -1, 0],
      [0, -1, 0, -1, 0, -1, -1, 0, -1, -1, -1, 0, -1, -1, 0, -1, 0, -1, 0],
      [0, -1, 0, -1, -1, 0, -1, -1, 0, 0, 0, -1, -1, 0, -1, -1, 0, -1, 0],
      [0, -1, -1, 0, -1, -1, 0, -1, -1, -1, -1, -1, 0, -1, -1, 0, -1, -1, 0],
      [0, 0, -1, -1, 0, -1, -1, 0, 0, 0, 0, 0, -1, -1, 0, -1, -1, 0, 0]
    ]
  },
  {
    "name": "太极",
    "map": [
      [-1, -1, -1, -1, 0, 0, 0, 0, 0, 0, 0, 0, 0, 0, -1, -1, -1, -1, -1],
      [-1, -1, -1, 0, 0, -1, -1, -1, -1, 0, 0, 0, 0, 0, 0, 0, 0, -1, -1],
      [-1, -1, 0, 0, -1, -1, -1, -1, 0, 0, -1, -1, -1, -1, -1, -1, 0, -1, -1],
      [-1, -1, 0, -1, -1, -1, -1, -1, 0, -1, -1, -1, 0, 0, -1, -1, 0, -1, -1],
      [-1, 0, -1, -1, -1, -1, -1, -1, 0, -1, -1, -1, 0, 0, -1, -1, 0, -1, -1],
      [-1, 0, -1, -1, -1, -1, -1, -1, 0, -1, -1, -1, -1, -1, -1, -1, 0, 0, -1],
      [-1, 0, -1, -1, -1, -1, -1, -1, 0, 0, 0, 0, -1, -1, -1, -1, -1, 0, -1],
      [-1, 0, -1, -1, 0, 0, -1, -1, -1, -1, -1, 0, -1, -1, -1, -1, 0, 0, -1],
      [-1, -1, 0, -1, 0, 0, -1, -1, -1, -1, -1, 0, -1, -1, -1, 0, 0, -1, -1],
      [-1, -1, 0, -1, -1, -1, -1, -1, 0, 0, 0, 0, -1, -1, 0, 0, -1, -1, -1],
      [-1, -1, -1, 0, 0, 0, 0, 0, 0, 0, 0, 0, 0, 0, 0, -1, -1, -1, -1]
    ]
  },
  {
    "name": "纵横交错",
    "map": [
      [0, -1, 0, -1, 0, -1, 0, -1, 0, -1, 0, -1, 0, -1, 0, -1, 0, -1, 0],
      [-1, 0, -1, 0, -1, 0, -1, 0, -1, 0, -1, 0, -1, 0, -1, 0, -1, 0, -1],
      [0, -1, 0, -1, 0, -1, 0, -1, 0, -1, 0, -1, 0, -1, 0, -1, 0, -1, 0],
      [-1, 0, -1, 0, -1, 0, -1, 0, -1, 0, -1, 0, -1, 0, -1, 0, -1, 0, -1],
      [0, -1, 0, -1, 0, -1, 0, -1, 0, -1, 0, -1, 0, -1, 0, -1, 0, -1, 0],
      [-1, 0, -1, 0, -1, 0, -1, 0, -1, -1, -1, 0, -1, 0, -1, 0, -1, 0, -1],
      [0, -1, 0, -1, 0, -1, 0, -1, 0, -1, 0, -1, 0, -1, 0, -1, 0, -1, 0],
      [-1, 0, -1, 0, -1, 0, -1, 0, -1, 0, -1, 0, -1, 0, -1, 0, -1, 0, -1],
      [0, -1, 0, -1, 0, -1, 0, -1, 0, -1, 0, -1, 0, -1, 0, -1, 0, -1, 0],
      [-1, 0, -1, 0, -1, 0, -1, 0, -1, 0, -1, 0, -1, 0, -1, 0, -1, 0, -1],
      [0, -1, 0, -1, 0, -1, 0, -1, 0, -1, 0, -1, 0, -1, 0, -1, 0, -1, 0]
    ]
  }
]
